NO textures/golden.xpm
SO textures/olivee.xpm
WE textures/burgundy.xpm
EA textures/baroque.xpm
F 66,40,29
C 245,240,220

111111111111111111111
10N000001100011000001
100000001100000000001
100000001100011000001
100000000000011000001
100000001100011000001
111111111111111111111