NO textures/wall_north.xpm
SO textures/wall_south.xpm
WE textures/wall_west.xpm
EA textures/wall_east.xpm
F 220,100,0
C 225,30,0

111111111111111111111
100000001000100000001
111100001000100000001
111000001000100000001
100000000000000000001
10000000000000N000001
111110000000000000001
100010000000000011111
100000000000000000001
111111111111111111111
