NO textures/white_marble_no.xpm
SO textures/white_brick_so.xpm
WE textures/pink_brick_we.xpm
EA textures/pink_marble_ea.xpm
F 255,192,203
C 250,250,250

111111111111111111111
100000001000100000001
111100001000100000001
111000001000100000001
100000000000000000001
10000000000000N000001
111110000000000000001
100010000000000011111
100000000000000000001
111111111111111111111
